



















                                        ######    
        #                              ########
       #                              ##########
      #                              ############
##################################################